flg22_seq	count	clust1	clust2	clust3	tabaci_ident	auriginosa_ident	Rhizo	Caulo	Sphingo	Beta	Gamma	Bacilli	Actino	other	operon	Arab	Poplar	Maize	Root	Shoot	Soil	T3SS	T6SS
RRISTGLKIAGPKDNPAIWAIA	3	0	0	3	50.00	45.45	0	3	0	0	0	0	0	0	0	3	0	0	3	0	0	0	0
SRINTGLRVANAKDNAAVYAIA	1	0	0	1	45.45	50.00	0	1	0	0	0	0	0	0	0	1	0	0	1	0	0	0	0
NRISTGMKVSSAKDNGAIFAIA	8	4	0	4	50.00	50.00	0	8	0	0	0	0	0	0	4	8	0	0	4	4	0	0	0
ARVSSGYRVETAADNAAYWSIA	4	0	0	4	45.45	45.45	4	0	0	0	0	0	0	0	0	4	0	0	4	0	0	0	4
GKISSGLRIQTAADNAAYWSIS	2	0	0	2	45.45	40.91	2	0	0	0	0	0	0	0	0	2	0	0	0	2	0	0	0
SRINTGLAISSAKDNAAVWSIA	4	4	0	0	54.55	54.55	0	4	0	0	0	0	0	0	4	4	0	0	4	0	0	0	1
QRLSSGLRINSAKDDAAGLAIS	47	28	0	19	81.82	81.82	0	0	0	34	13	0	0	0	28	47	0	0	28	19	0	3	23
AHVSSGLRVGSASDNAAYWSIA	1	0	0	1	50.00	45.45	1	0	0	0	0	0	0	0	0	1	0	0	1	0	0	0	0
QRLSSGMRINSAKDDAAGLAIS	1	0	0	1	77.27	81.82	0	0	0	1	0	0	0	0	0	1	0	0	1	0	0	1	1
ERISSGLRVGTAADNAAYWSIA	2	0	0	2	50.00	45.45	2	0	0	0	0	0	0	0	0	2	0	0	2	0	0	0	0
EKLASGLRINRAGDDAAGLAIS	3	1	0	2	63.64	59.09	0	0	0	0	0	3	0	0	1	3	0	0	0	2	1	0	0
EKLSSGLRINRAADDAAGLAVS	1	0	0	1	63.64	59.09	0	0	0	0	0	1	0	0	0	1	0	0	0	1	0	0	0
NAVSSGLRVGKASDNAAYWSIA	1	1	0	0	45.45	40.91	1	0	0	0	0	0	0	0	1	1	0	0	1	0	0	0	0
NHVATGLRVATAADNAAYWSIA	1	0	0	1	36.36	40.91	1	0	0	0	0	0	0	0	0	1	0	0	1	0	0	0	0
KQISTGLRVEKAADNAAYWSIA	1	0	0	1	40.91	45.45	1	0	0	0	0	0	0	0	0	1	0	0	1	0	0	0	0
DRVSSGQKVGDASDNVAYWSIS	1	0	0	1	40.91	31.82	1	0	0	0	0	0	0	0	0	1	0	0	0	1	0	0	1
NRINTGKKVASAKDNGAIWAIA	1	0	0	1	45.45	45.45	0	1	0	0	0	0	0	0	0	1	0	0	0	1	0	0	0
NRVSSGYKVSQASDNVAYWSIS	3	3	0	0	40.91	31.82	3	0	0	0	0	0	0	0	3	3	0	0	1	2	0	0	3
SRINSGLNVASTKDDSAAFTIA	3	0	0	3	50.00	40.91	0	0	3	0	0	0	0	0	0	3	0	0	0	3	0	0	0
NKINTGLRVSSAKDNAAVYAIA	3	2	0	1	45.45	50.00	0	3	0	0	0	0	0	0	2	3	0	0	3	0	0	0	0
QRINTGKKISTAKDNGAIWATA	1	0	0	1	40.91	45.45	0	1	0	0	0	0	0	0	0	1	0	0	1	0	0	0	0
EKLSSGLKINRAGDDAAGLAIS	6	5	0	1	72.73	59.09	0	0	0	0	0	6	0	0	5	6	0	0	6	0	0	0	0
EKLSSGLRINKAGDDAAGLAIS	1	0	0	1	68.18	63.64	0	0	0	0	0	1	0	0	0	1	0	0	1	0	0	0	0
SRINTGKRIATAKDNGAIWSMA	2	2	0	0	36.36	45.45	0	2	0	0	0	0	0	0	2	2	0	0	2	0	0	0	2
SRINTGKKVASAKDNGAVWAIA	1	1	0	0	45.45	45.45	0	1	0	0	0	0	0	0	1	1	0	0	0	1	0	0	0
ARLSSGQRINSAKDDAAGLAIS	1	0	0	1	77.27	77.27	0	0	1	0	0	0	0	0	0	1	0	0	0	1	0	0	0
QRINTGKKVANSKDNGAIWAMA	1	0	0	1	31.82	36.36	0	1	0	0	0	0	0	0	0	1	0	0	1	0	0	0	0
NRVSTGQRISSAADGAAYWSIA	1	1	0	0	50.00	59.09	1	0	0	0	0	0	0	0	1	1	0	0	0	1	0	0	0
EKLSSGLRINRAADDASGLTIS	1	0	0	1	63.64	59.09	0	0	0	0	0	0	1	0	0	1	0	0	0	1	0	0	0
ARVSSGLRVGEAADNAAYWSIA	4	0	0	4	50.00	45.45	4	0	0	0	0	0	0	0	0	4	0	0	4	0	0	0	4
TRLSTGYRINSAMDDAAGLQIA	3	0	0	3	81.82	86.36	0	0	0	3	0	0	0	0	0	3	0	0	3	0	0	1	3
TRLSSGKRINSAADDAAGLAIS	3	0	0	3	77.27	72.73	0	0	0	3	0	0	0	0	0	3	0	0	3	0	0	2	3
QRLSSGLRVNSAKDDAAGMSIA	1	0	0	1	77.27	77.27	0	0	0	1	0	0	0	0	0	1	0	0	0	1	0	0	1
ARISTGYRVSQASDNAAYWSIA	5	5	0	0	40.91	50.00	5	0	0	0	0	0	0	0	5	5	0	0	5	0	0	0	0
GRVSSGLRVETASDNAAYWSIA	2	0	0	2	50.00	45.45	2	0	0	0	0	0	0	0	0	2	0	0	2	0	0	0	0
NTVSTGLKVSSAKDNVAYWSIS	3	3	0	0	45.45	40.91	3	0	0	0	0	0	0	0	3	3	0	0	1	2	0	0	3
ARISTGYRVAEAMDNAAYWSIA	1	1	0	0	40.91	50.00	1	0	0	0	0	0	0	0	1	1	0	0	1	0	0	0	0
SRVNTGLKVQGARDNAAVWAVA	4	4	0	0	40.91	36.36	0	4	0	0	0	0	0	0	4	4	0	0	2	2	0	0	0
DVITTGMRISEAADNAAYWSIA	4	0	0	4	36.36	45.45	4	0	0	0	0	0	0	0	0	4	0	0	4	0	0	0	0
EKLSSGLRINSASDDAAGLAIS	1	0	0	1	72.73	68.18	0	0	0	0	0	1	0	0	0	1	0	0	0	1	0	0	0
QRINTGKKIGNAKDNGAIWSMA	1	1	0	0	40.91	45.45	0	1	0	0	0	0	0	0	1	1	0	0	1	0	0	0	1
RHISTGLAISSPKDNAAVWAIA	2	0	0	2	50.00	50.00	0	2	0	0	0	0	0	0	0	2	0	0	2	0	0	0	0
QRLSSGLRINSAKDDAAGLAIA	2	2	0	0	86.36	86.36	0	0	0	2	0	0	0	0	2	2	0	0	2	0	0	0	2
QRLSTGLRVNSAKDDAAAYAVA	1	0	0	1	NA	NA	0	0	0	1	0	0	0	0	0	1	0	0	1	0	0	0	1
THLSTGKRINSAADDAAGLAIS	2	0	0	2	68.18	72.73	0	0	2	0	0	0	0	0	0	2	0	0	0	2	0	0	0
ERISSGYRVQTAADNAAYWSIA	6	2	0	4	45.45	45.45	6	0	0	0	0	0	0	0	2	6	0	0	6	0	0	0	0
TRLSTGYRVNSAQDDAAGLQIA	2	0	0	2	77.27	81.82	0	0	0	2	0	0	0	0	0	2	0	0	2	0	0	0	2
QRINTGKKIGNAKDNGAIWAMA	1	0	0	1	40.91	45.45	0	1	0	0	0	0	0	0	0	1	0	0	1	0	0	1	1
GRISSGLRVGDASDNAAYWSIA	2	1	0	1	50.00	45.45	2	0	0	0	0	0	0	0	1	2	0	0	1	1	0	0	0
ERLSTGKRINSAKDDAAGMAIS	3	0	0	3	68.18	77.27	0	0	3	0	0	0	0	0	0	3	0	0	0	3	0	0	0
GRISTGLSVASTKDDSSSYVIA	1	0	0	1	45.45	45.45	0	0	1	0	0	0	0	0	0	1	0	0	0	1	0	0	0
ERLSSGLRINKAADDAAGLAIS	2	0	0	2	72.73	68.18	0	0	0	0	0	0	2	0	0	2	0	0	2	0	0	0	0
QRLSTGLRVNSAQDDAAAYAVA	1	0	0	1	59.09	68.18	0	0	0	1	0	0	0	0	0	1	0	0	1	0	0	0	1
QRLSSGLRINSAKDDAAGLQIS	3	0	0	3	86.36	86.36	0	0	0	0	3	0	0	0	0	3	0	0	2	1	0	1	2
SRISTGQKVSSAADNAAYWSIA	1	0	0	1	50.00	50.00	1	0	0	0	0	0	0	0	0	1	0	0	1	0	0	0	0
DRVSSGFRVGQAKDNVAYWSIS	1	1	0	0	40.91	40.91	1	0	0	0	0	0	0	0	1	1	0	0	0	1	0	0	1
ERLSSGMKINSAKDDAAGLAIS	1	0	0	1	81.82	72.73	0	0	0	0	1	0	0	0	0	1	0	0	0	0	1	1	0
TRLSSGKRINSAADDAAGQAIA	1	0	0	1	77.27	72.73	0	0	0	1	0	0	0	0	0	1	0	0	0	1	0	0	1
GRISSGLKVGTAADNSAYWSIA	3	0	0	3	50.00	36.36	3	0	0	0	0	0	0	0	0	3	0	0	3	0	0	0	0
SAISSGYSVASASDNAAYWSIA	1	1	0	0	45.45	40.91	1	0	0	0	0	0	0	0	1	1	0	0	1	0	0	0	0
GRISTGLKVQGAKDNAAIWAIA	5	4	0	1	54.55	50.00	0	5	0	0	0	0	0	0	4	5	0	0	4	1	0	0	0
RHIATGLAISSPKDNPAVWAIA	2	0	0	2	40.91	40.91	0	2	0	0	0	0	0	0	0	2	0	0	2	0	0	2	2
NRISTGLKIGEAKDNAAYWSIS	1	0	0	1	54.55	50.00	1	0	0	0	0	0	0	0	0	1	0	0	0	1	0	0	0
NRISTGKTVATAKDNGAIWAIA	1	0	0	1	40.91	45.45	0	1	0	0	0	0	0	0	0	1	0	0	1	0	0	0	0
DRLATGNKVNSALDNPSNWFTA	2	0	0	2	40.91	40.91	2	0	0	0	0	0	0	0	0	2	0	0	2	0	0	0	1
QQVSSGKRVETAADDATYWSFA	1	1	0	0	36.36	40.91	1	0	0	0	0	0	0	0	1	1	0	0	1	0	0	0	0
NRVSTGQRISSAADGAAYWAIA	1	1	0	0	50.00	59.09	1	0	0	0	0	0	0	0	1	1	0	0	0	1	0	0	0
ERLSSGMRINSAKDDAAGLAIS	4	0	0	4	77.27	77.27	0	0	0	0	4	0	0	0	0	4	0	0	4	0	0	2	2
NRVSTGQRVSSAADNAAYWSIA	6	0	0	6	45.45	54.55	6	0	0	0	0	0	0	0	0	6	0	0	0	6	0	0	0
DRISSGYRVQTAADNAAYWSIA	5	0	0	5	45.45	45.45	5	0	0	0	0	0	0	0	0	5	0	0	5	0	0	0	0
EKLSSGLRINSAADDAAGLAIS	2	1	0	1	72.73	68.18	0	0	0	0	0	2	0	0	1	2	0	0	2	0	0	0	0
TRLGTGLRINSAKDDAAGLQIA	2	0	0	2	86.36	86.36	0	0	0	2	0	0	0	0	0	2	0	0	2	0	0	0	2
DRMTTGFKVRSAKDNASVWQAA	1	0	0	1	45.45	45.45	1	0	0	0	0	0	0	0	0	1	0	0	0	1	0	0	0
QQVSSGLRVQTAADNVAYWSIS	2	0	0	2	36.36	36.36	2	0	0	0	0	0	0	0	0	2	0	0	0	2	0	0	0
AMVSSGYRISTATDNAAYWSIS	4	0	0	4	40.91	40.91	4	0	0	0	0	0	0	0	0	4	0	0	4	0	0	0	4
NRVSTGLKVGSAKDNGAIYAIA	4	4	0	0	54.55	50.00	0	4	0	0	0	0	0	0	4	4	0	0	2	2	0	0	0
QRINTGKKISNAKDNGAIWSMA	4	4	0	0	40.91	45.45	0	4	0	0	0	0	0	0	4	4	0	0	4	0	0	3	3
SRISSGYRVETAADNAAYWSIA	3	1	0	2	45.45	45.45	3	0	0	0	0	0	0	0	1	3	0	0	0	3	0	0	0
RQVSTGLRVERASDNGAYWAIS	4	0	0	4	31.82	36.36	4	0	0	0	0	0	0	0	0	4	0	0	4	0	0	0	0
NRINTGKAVSSAKDNGAIFAIA	1	1	0	0	40.91	45.45	0	1	0	0	0	0	0	0	1	1	0	0	1	0	0	0	0
ERVTSGLKIASAADNSGYWSTA	1	1	0	0	45.45	31.82	1	0	0	0	0	0	0	0	1	1	0	0	0	1	0	0	1
QRLSSGLRINSAKDDAAGQAIA	7	0	0	7	81.82	81.82	0	0	0	7	0	0	0	0	0	7	0	0	7	0	0	0	0
GRVSSGLRVERAADNAAYWSIA	1	0	0	1	50.00	45.45	1	0	0	0	0	0	0	0	0	1	0	0	1	0	0	0	0
QRLSSGLRINSSKDDAAGLAIA	3	0	0	3	81.82	81.82	0	0	0	3	0	0	0	0	0	3	0	0	0	3	0	0	0
QNISSGLRIGEASDNAAYWSIA	1	0	0	1	50.00	50.00	1	0	0	0	0	0	0	0	0	1	0	0	1	0	0	0	0
NAVSSGLRVGKAADNAAYWSIA	3	2	0	1	45.45	40.91	3	0	0	0	0	0	0	0	2	3	0	0	3	0	0	0	0
NRISTGKSVSSAKDNGAIWAIA	1	1	0	0	45.45	50.00	0	1	0	0	0	0	0	0	1	1	0	0	1	0	0	0	0
AKLSSGSRIVSAKDDASGLAIA	1	0	0	1	68.18	72.73	0	1	0	0	0	0	0	0	0	1	0	0	1	0	0	0	0
RQVTTGLRVEKASDNGAYWAIS	2	0	0	2	27.27	31.82	2	0	0	0	0	0	0	0	0	2	0	0	2	0	0	0	0
SRISTGYRVSEAADNAAYWSIA	1	1	0	0	40.91	50.00	1	0	0	0	0	0	0	0	1	1	0	0	1	0	0	0	0
ARLSSGLRINSAKDDAAGLAIS	1	1	0	0	81.82	77.27	0	0	0	1	0	0	0	0	1	1	0	0	0	1	0	0	1
TNISTGYRVQQASDDVAYWSIA	1	0	0	1	40.91	45.45	1	0	0	0	0	0	0	0	0	1	0	0	0	1	0	0	0
AKLSSGLRINTAADDAAGLTVS	1	0	0	1	63.64	59.09	0	0	0	0	0	0	1	0	0	1	0	0	1	0	0	0	0
NRLSTGKKINSAKDDAAGMQIA	1	0	0	1	81.82	81.82	0	0	0	0	1	0	0	0	0	1	0	0	1	0	0	1	1
SRINTGLNVSSTKDDSASYTIA	1	0	0	1	45.45	45.45	0	0	1	0	0	0	0	0	0	1	0	0	1	0	0	1	0
ERLSSGLRINSAKDDAAGMAIA	3	0	0	3	81.82	77.27	0	0	0	3	0	0	0	0	0	3	0	0	3	0	0	1	1
EKLSSGLRINRAADDAAGLSIS	16	1	0	15	68.18	63.64	0	0	0	0	0	9	7	0	1	16	0	0	11	5	0	0	0
ARVSSGYRVETASDNAAYWSIA	4	4	0	0	45.45	45.45	4	0	0	0	0	0	0	0	4	4	0	0	0	4	0	0	0
NRVSTGQRVSTASDNAAYWSIA	8	0	0	8	40.91	50.00	8	0	0	0	0	0	0	0	0	8	0	0	0	8	0	0	1
SRLSSGMRINSAKDDAAGLAIS	1	0	0	1	77.27	77.27	0	0	0	0	1	0	0	0	0	1	0	0	0	0	1	0	0
ERLSTGKSINSAKDNAAGMAIK	2	0	0	2	63.64	68.18	0	0	2	0	0	0	0	0	0	2	0	0	0	2	0	0	1
EKLSSGLRINNAADDAAGLAIS	1	0	0	1	68.18	63.64	0	0	0	0	0	1	0	0	0	1	0	0	1	0	0	0	0
ERLSTGKRINSAKDDAAGMAIA	1	0	0	1	72.73	81.82	0	0	1	0	0	0	0	0	0	1	0	0	0	1	0	0	0
QRLSSGLRVNSARDDAAGLAIA	2	2	0	0	77.27	77.27	0	0	0	2	0	0	0	0	2	2	0	0	2	0	0	0	0
RQVSTGLRVERAADNGAYWAIS	1	1	0	0	31.82	36.36	1	0	0	0	0	0	0	0	1	1	0	0	1	0	0	0	0
QRINTGKKIGNAKDNGAIWAMS	1	0	0	1	36.36	40.91	0	1	0	0	0	0	0	0	0	1	0	0	1	0	0	1	1
NRLSSGKRINSAADDAAGLAIA	1	0	0	1	77.27	77.27	0	0	0	0	0	1	0	0	0	1	0	0	1	0	0	0	0
GNVSSGYRVAEAKDNAAYWSIA	1	1	0	0	45.45	45.45	1	0	0	0	0	0	0	0	1	1	0	0	1	0	0	0	0
DRVSSGYKVAQASDNVAYWSIS	1	1	0	0	40.91	31.82	1	0	0	0	0	0	0	0	1	1	0	0	0	1	0	0	1
REVSSGLRVGTASDNAAYWSIA	2	0	0	2	45.45	40.91	2	0	0	0	0	0	0	0	0	2	0	0	2	0	0	0	0
GRISSGLRVGSASDNAAYWSIA	2	1	0	1	54.55	50.00	2	0	0	0	0	0	0	0	1	2	0	0	2	0	0	0	0
NRLSSGKSINSAADDAAGLAIA	10	7	0	3	77.27	72.73	0	0	0	0	0	10	0	0	7	10	0	0	10	0	0	0	0
QRLSSGTRINSAKDDAAGLAIS	1	1	0	0	77.27	81.82	0	0	0	1	0	0	0	0	1	1	0	0	0	1	0	0	1
DRVSSGLRVGEASDNAAYWSIA	1	1	0	0	50.00	45.45	1	0	0	0	0	0	0	0	1	1	0	0	1	0	0	0	0
NRLATGQRISTASDSAAYWSIA	1	0	0	1	45.45	54.55	1	0	0	0	0	0	0	0	0	1	0	0	0	1	0	0	0
NRINTGLKISSAKDNGAIWAIA	2	2	0	0	54.55	50.00	0	2	0	0	0	0	0	0	2	2	0	0	2	0	0	0	0
NVMTTGMRISEAADNAAYWSIA	3	0	0	3	36.36	45.45	3	0	0	0	0	0	0	0	0	3	0	0	0	3	0	0	0
SRINTGLAISTAKDNAAVWSIA	3	3	0	0	50.00	50.00	0	3	0	0	0	0	0	0	3	3	0	0	3	0	0	3	3
GRVSSGLRVETAADNAAYWSIA	5	0	0	5	50.00	45.45	5	0	0	0	0	0	0	0	0	5	0	0	5	0	0	0	0
DRISSGYRVGNASDNAAYWSIA	4	1	0	3	45.45	45.45	4	0	0	0	0	0	0	0	1	4	0	0	4	0	0	0	0
QRLGSGMRINSAKDDAAGLAIS	1	1	0	0	72.73	77.27	0	0	0	0	1	0	0	0	1	1	0	0	1	0	0	0	0
EKLSTGLRINRAGDDAAGLSIS	1	0	0	1	63.64	68.18	0	0	0	0	0	0	1	0	0	1	0	0	0	0	1	0	0
NRVSTGQRVSNAADNAAYWSIA	2	0	0	2	40.91	50.00	2	0	0	0	0	0	0	0	0	2	0	0	0	2	0	0	0
SRISTGYRVNDASDNAAYWSIA	2	1	0	1	45.45	54.55	2	0	0	0	0	0	0	0	1	2	0	0	2	0	0	0	0
EKLSSGFRINRAADDAAGLAIS	17	0	0	17	63.64	63.64	0	0	0	0	0	1	16	0	0	17	0	0	11	5	1	0	0
SRINTGLKVASTKDDSASYTIA	1	0	0	1	50.00	45.45	0	0	1	0	0	0	0	0	0	1	0	0	1	0	0	0	0
DRISSGMRVGSASDNAAYWSIA	1	1	0	0	50.00	50.00	1	0	0	0	0	0	0	0	1	1	0	0	1	0	0	0	0
NRLSSGKRINTAADDAAGLAIS	2	0	0	2	68.18	68.18	0	0	0	2	0	0	0	0	0	2	0	0	2	0	0	0	2
ARVSSGLRVETASDNAAYWSIA	2	2	0	0	50.00	45.45	2	0	0	0	0	0	0	0	2	2	0	0	2	0	0	0	0
QQVSSGFRVETAADDATYWSYA	1	1	0	0	36.36	40.91	1	0	0	0	0	0	0	0	1	1	0	0	1	0	0	0	0
TRLSTGYRVNSAMDDAAGLQIA	2	0	0	2	77.27	81.82	0	0	0	2	0	0	0	0	0	2	0	0	0	2	0	0	1
NRINSGLNVSSTKDDSAAFTIA	2	0	0	2	50.00	40.91	0	0	2	0	0	0	0	0	0	2	0	0	0	2	0	0	1
ARVSSGMRVQTAADNAAYWSIA	1	1	0	0	45.45	45.45	1	0	0	0	0	0	0	0	1	1	0	0	1	0	0	0	0
SQISSGLSVQTAADNAAYWSIS	3	0	0	3	40.91	31.82	3	0	0	0	0	0	0	0	0	3	0	0	3	0	0	0	0
DKLSSGQKINRAADDAAGLALS	1	0	0	1	63.64	54.55	0	0	0	0	0	1	0	0	0	1	0	0	0	1	0	0	0
SRISTGFRVAEASDNAAYWSIA	1	1	0	0	40.91	50.00	1	0	0	0	0	0	0	0	1	1	0	0	1	0	0	0	0
TRLSSGLKINSAKDDAAGLQIA	14	0	0	14	100.00	81.82	0	0	0	0	14	0	0	0	0	14	0	0	12	2	0	2	3
ERLSSGKRINSAKDDAAGLAIA	4	1	0	3	81.82	81.82	0	0	4	0	0	0	0	0	1	4	0	0	3	1	0	0	0
ARVSSGYRVETAADNAAYWSIS	4	0	0	4	40.91	40.91	4	0	0	0	0	0	0	0	0	4	0	0	4	0	0	0	1
NRISTGLRISEASDNASYWSIA	2	0	0	2	45.45	50.00	2	0	0	0	0	0	0	0	0	2	0	0	2	0	0	0	0
DVISTGLKIAGASDNAAYWAIA	4	0	0	4	50.00	45.45	4	0	0	0	0	0	0	0	0	4	0	0	4	0	0	0	0
QQVSSGKSVETAADDATYWSFA	1	1	0	0	36.36	36.36	1	0	0	0	0	0	0	0	1	1	0	0	1	0	0	0	0
DRIATGQRVAQASDNAAYWSIA	3	0	0	3	36.36	45.45	3	0	0	0	0	0	0	0	0	3	0	0	3	0	0	0	0
ARLSSGKRINSAKDDAAGLAIA	4	4	0	0	81.82	81.82	0	0	4	0	0	0	0	0	4	4	0	0	4	0	0	0	0
ERLSTGQRINSAKDDAAGLAIS	1	1	0	0	72.73	81.82	0	0	1	0	0	0	0	0	1	1	0	0	0	1	0	0	0
DRLSSGKRINNASDDAAGLAIA	1	0	0	1	72.73	72.73	0	0	0	0	0	1	0	0	0	1	0	0	1	0	0	0	0
SRISSGLKVGSASDNAAYWSIS	4	4	0	0	54.55	40.91	4	0	0	0	0	0	0	0	4	4	0	0	0	4	0	0	0
RRISTGLKIASAKDNPAIWAIA	1	0	0	1	59.09	54.55	0	1	0	0	0	0	0	0	0	1	0	0	1	0	0	0	0
NRVSTGQRVSAASDNAAYWSIA	2	0	0	2	40.91	50.00	2	0	0	0	0	0	0	0	0	2	0	0	1	1	0	0	0
EKLSSGLRINRAADDAAGLAIS	30	0	0	30	68.18	63.64	0	0	0	0	0	0	30	0	0	30	0	0	18	12	0	0	0
ERLSSGKRINSAKDDAAGMAIA	4	4	0	0	77.27	77.27	0	0	4	0	0	0	0	0	4	4	0	0	4	0	0	0	0
TRLSSGLKINSAKDDAAGLQIS	1	0	0	1	95.45	77.27	0	0	0	0	1	0	0	0	0	1	0	0	0	1	0	0	0
ERLSTGKRINSAKDDAAGLAIA	25	2	0	23	77.27	86.36	0	0	25	0	0	0	0	0	2	25	0	0	3	22	0	2	8
AQVSSGLRIKSASDNVAYWSIS	1	0	0	1	45.45	40.91	1	0	0	0	0	0	0	0	0	1	0	0	0	1	0	0	1
NVVTTGMRISEAADNAAYWSIA	1	0	0	1	36.36	45.45	1	0	0	0	0	0	0	0	0	1	0	0	1	0	0	0	0
NRISTGLKVSSAKDNGAIFAIA	4	4	0	0	54.55	50.00	0	4	0	0	0	0	0	0	4	4	0	0	2	2	0	0	0
QRVATGLRVSSASDGAAYWAIA	1	0	0	1	45.45	54.55	1	0	0	0	0	0	0	0	0	1	0	0	0	1	0	0	0
EKLASGLRINRAGDDAAGLSIS	5	2	0	3	63.64	59.09	0	0	0	0	0	5	0	0	2	5	0	0	4	1	0	0	0
EKLSSGFRINRAADDAAGLSIS	3	0	0	3	63.64	63.64	0	0	0	0	0	2	1	0	0	3	0	0	2	0	1	0	0
TRLSSGLKINSAKDDAAGMQIA	1	0	0	1	95.45	77.27	0	0	0	0	1	0	0	0	0	1	0	0	1	0	0	1	1
QRLSSGLRVNSAKDDAAGLAIA	17	14	0	3	81.82	81.82	0	0	0	17	0	0	0	0	14	17	0	0	14	3	0	6	5
QITSSGLKIGKAADNAGYWSTA	4	4	0	0	45.45	36.36	4	0	0	0	0	0	0	0	4	4	0	0	1	3	0	0	4
GQLNSGLRIQTAADNAAYWSIS	5	0	0	5	45.45	40.91	5	0	0	0	0	0	0	0	0	5	0	0	5	0	0	0	0
KRTSSGYKINSPADNASYWSVA	2	2	0	0	50.00	40.91	2	0	0	0	0	0	0	0	2	2	0	0	0	2	0	0	0
QRINTGKKVGNAKDNGAIWAMA	6	1	0	5	36.36	40.91	0	6	0	0	0	0	0	0	1	6	0	0	6	0	0	2	5
QRLSTGLRVEQAADNAAYWSIA	1	0	0	1	50.00	59.09	1	0	0	0	0	0	0	0	0	1	0	0	1	0	0	0	0
GRIATGLRVAEASDNAAYWSIA	5	2	0	3	40.91	45.45	5	0	0	0	0	0	0	0	2	5	0	0	5	0	0	0	0
VRVATGRDVNQAADNAAYWSIA	1	0	0	1	40.91	45.45	1	0	0	0	0	0	0	0	0	1	0	0	1	0	0	0	0
DRVSSGYRVGQAKDNVAYWSIS	1	1	0	0	40.91	40.91	1	0	0	0	0	0	0	0	1	1	0	0	0	1	0	0	0
KRVSTGLRVGTASDNAAYWSIA	1	1	0	0	45.45	50.00	1	0	0	0	0	0	0	0	1	1	0	0	1	0	0	0	0
GRVSSGLRVQTAADNAAYWSIG	3	0	0	3	45.45	40.91	3	0	0	0	0	0	0	0	0	3	0	0	0	3	0	0	0
SRISTGYRVAEAVDNAAYWSIA	2	2	0	0	40.91	50.00	2	0	0	0	0	0	0	0	2	2	0	0	2	0	0	0	0
ARLSSGARIGGASDDPAGQALA	1	0	0	1	54.55	54.55	0	0	0	1	0	0	0	0	0	1	0	0	1	0	0	1	1
SRVSSGMRVKTASDNAAYWSIA	1	1	0	0	45.45	45.45	1	0	0	0	0	0	0	0	1	1	0	0	1	0	0	0	0
NRVSTGMKVAVAADNAAYWSIA	1	0	0	1	45.45	45.45	1	0	0	0	0	0	0	0	0	1	0	0	1	0	0	0	0
NRINTGKSVATAKDNGAIWAIA	1	0	0	1	36.36	40.91	0	1	0	0	0	0	0	0	0	1	0	0	1	0	0	0	0
EKLSSGQRINSAADDAAGLAIS	1	0	0	1	68.18	68.18	0	0	0	0	0	1	0	0	0	1	0	0	1	0	0	0	0
NRISSGYRVETAADNAAYWSIA	5	2	0	3	45.45	45.45	5	0	0	0	0	0	0	0	2	5	0	0	5	0	0	0	0
DIVTTGMRISEAADNAAYWSIA	2	0	0	2	36.36	45.45	2	0	0	0	0	0	0	0	0	2	0	0	2	0	0	0	0
GQVSTGLRISEASHNAAYWSIA	1	0	0	1	40.91	45.45	1	0	0	0	0	0	0	0	0	1	0	0	1	0	0	0	0
ERLSSGLRINSAKDDAAGQAIS	1	0	0	1	77.27	72.73	0	0	0	0	1	0	0	0	0	1	0	0	0	1	0	0	1
GRISTGLKVGSASDNAAYWSIA	2	2	0	0	54.55	50.00	2	0	0	0	0	0	0	0	2	2	0	0	2	0	0	0	1
DRVSSGLKIADASDGAAYWSIA	1	1	0	0	59.09	45.45	1	0	0	0	0	0	0	0	1	1	0	0	0	1	0	0	0
QRLSSGMRVNSAKDDAAGLAIA	4	4	0	0	77.27	81.82	0	0	0	4	0	0	0	0	4	4	0	0	4	0	0	2	0
DRVSSGEKVGKAADNVAYWSIS	1	1	0	0	40.91	31.82	1	0	0	0	0	0	0	0	1	1	0	0	0	1	0	0	0
QRITSGKRINSAKDDAAGLAIA	2	2	0	0	72.73	77.27	0	0	0	0	2	0	0	0	2	2	0	0	2	0	0	0	2
ERLSSGLRINSAKDDAAGQAIA	1	0	0	1	81.82	77.27	0	0	0	0	1	0	0	0	0	1	0	0	0	1	0	0	1
QRINTGKKIANAKDNGAIWSMA	2	2	0	0	40.91	45.45	0	2	0	0	0	0	0	0	2	2	0	0	2	0	0	0	0
NRVSTGQRVSAAADNAAYWSIA	1	0	0	1	40.91	50.00	1	0	0	0	0	0	0	0	0	1	0	0	0	1	0	0	0
NRISTGKNVSSAKDNGAIFAIA	2	2	0	0	45.45	50.00	0	2	0	0	0	0	0	0	2	2	0	0	2	0	0	0	0
TRLSSGLRINSAKDDAAGLQIA	2	0	0	2	95.45	86.36	0	0	0	0	2	0	0	0	0	2	0	0	1	1	0	0	1
ERLSSGNRINSAKDDAAGLAIS	4	3	0	1	77.27	77.27	0	0	0	0	4	0	0	0	3	4	0	0	4	0	0	0	3
DRVSSGYKVSKASDNVAYWSIS	2	2	0	0	40.91	31.82	2	0	0	0	0	0	0	0	2	2	0	0	0	2	0	0	0
TRINTGQSISTAKDNAAVWSIA	2	2	0	0	50.00	50.00	0	2	0	0	0	0	0	0	2	2	0	0	2	0	0	0	2
SSVSSGLRVGQASDNVAYWSIS	3	3	0	0	36.36	31.82	3	0	0	0	0	0	0	0	3	3	0	0	1	2	0	0	3
QRINTGKKISSAKDNGAIWATA	2	1	0	1	45.45	50.00	0	2	0	0	0	0	0	0	1	2	0	0	2	0	0	2	2
RMVSSGMRVQVSADNAAYWSIS	1	1	0	0	31.82	31.82	1	0	0	0	0	0	0	0	1	1	0	0	1	0	0	0	0
SRVSSGLRVKTASDNAAYWSIA	7	7	0	0	50.00	45.45	7	0	0	0	0	0	0	0	7	7	0	0	7	0	0	0	5
GRISTGYRVATASDNAAYWSIA	2	2	0	0	40.91	50.00	2	0	0	0	0	0	0	0	2	2	0	0	2	0	0	0	0
DRVSSGQRVGEASDNAAYWSIA	3	3	0	0	45.45	45.45	3	0	0	0	0	0	0	0	3	3	0	0	3	0	0	0	1
EKLSTGLRINRAADDAAGLSIS	2	0	0	2	63.64	68.18	0	0	0	0	0	0	2	0	0	2	0	0	1	1	0	0	0
ARLSSGNRINSAKDDAAGLAIS	2	0	0	2	77.27	77.27	0	0	0	0	2	0	0	0	0	2	0	0	2	0	0	0	2
NRVSTGLKVATAADNAAYWSIA	2	0	0	2	50.00	45.45	2	0	0	0	0	0	0	0	0	2	0	0	2	0	0	0	0
ERLSSGLRINSARDDAAGLAIS	1	0	0	1	77.27	72.73	0	0	0	1	0	0	0	0	0	1	0	0	1	0	0	0	0
EKLSSGLRINKASDDAAGLAIS	1	0	0	1	68.18	63.64	0	0	0	0	0	1	0	0	0	1	0	0	1	0	0	0	0
NHVSSGYRIETASDNAAYWSIA	1	1	0	0	45.45	45.45	1	0	0	0	0	0	0	0	1	1	0	0	1	0	0	0	0
NRVSTGQRVSSASDNAAYWSIA	1	0	0	1	45.45	54.55	1	0	0	0	0	0	0	0	0	1	0	0	0	1	0	0	0
DRVSTGLKIGDASDGAAYWSIA	1	1	0	0	54.55	50.00	1	0	0	0	0	0	0	0	1	1	0	0	0	1	0	0	1
ARISSGYRVETAADNAAYWSIA	3	2	0	1	45.45	45.45	3	0	0	0	0	0	0	0	2	3	0	0	3	0	0	0	0
GRISSGLKVGSASDNAAYWSIA	1	0	0	1	59.09	45.45	1	0	0	0	0	0	0	0	0	1	0	0	1	0	0	0	0
GRISTGLKIGEAKDNAAYWSIS	1	0	0	1	54.55	50.00	1	0	0	0	0	0	0	0	0	1	0	0	0	1	0	0	0
EKLSSGLNINRAADDAAGMSIS	1	0	0	1	63.64	54.55	0	0	0	0	0	1	0	0	0	1	0	0	0	1	0	0	0
GEVSSGLRVQNAQDNAAYWSIA	1	0	0	1	45.45	40.91	1	0	0	0	0	0	0	0	0	1	0	0	1	0	0	0	0
NRIATGQRVSTASDNAAYWSIA	1	0	0	1	36.36	45.45	1	0	0	0	0	0	0	0	0	1	0	0	1	0	0	0	0
DRLSSGKRINSASDDAAGLAIA	2	0	0	2	77.27	77.27	0	0	0	0	0	2	0	0	0	2	0	0	2	0	0	0	0
EKLSSGLRINRAGDDAAGLAIS	17	1	0	16	68.18	63.64	0	0	0	0	0	13	4	0	1	17	0	0	11	2	4	0	0
ERLSTGKRINSAKDDAAGLAIS	12	5	0	7	72.73	81.82	0	0	12	0	0	0	0	0	5	12	0	0	1	11	0	1	0
NRINTGKSVSSAKDNGSIWAIA	2	0	0	2	36.36	40.91	0	2	0	0	0	0	0	0	0	2	0	0	2	0	0	0	0
NSVSTGYKVSKASDNVAYWSIS	2	2	0	0	31.82	31.82	2	0	0	0	0	0	0	0	2	2	0	0	0	2	0	0	0
GRVSSGLKVGVAADNAAYWSIA	4	2	0	2	54.55	40.91	4	0	0	0	0	0	0	0	2	4	0	0	0	4	0	0	0
SRVSSGYRVSEASDNVAYWSIS	2	2	0	0	36.36	36.36	2	0	0	0	0	0	0	0	2	2	0	0	0	2	0	0	0
QRLSSGLKINSAKDDAAGLQIA	2	0	0	2	95.45	86.36	0	0	0	0	2	0	0	0	0	2	0	0	2	0	0	0	2
NRVSTGQRVSNASDNAAYWSIA	5	0	0	5	40.91	50.00	5	0	0	0	0	0	0	0	0	5	0	0	0	5	0	0	0
LRLSSGMRINGAKDDAAGQAIA	1	0	0	1	72.73	72.73	0	0	0	0	1	0	0	0	0	1	0	0	0	1	0	0	1
NRLSSGKRINTAADDAAGLAIA	1	0	0	1	72.73	72.73	0	0	0	0	0	1	0	0	0	1	0	0	1	0	0	0	0
QRLGTGFRINSAADDAAGLQIA	1	0	0	1	72.73	86.36	0	0	0	0	1	0	0	0	0	1	0	0	0	1	0	0	0
ARLSSGTSIASAADDPAGQAIT	2	0	0	2	59.09	54.55	0	0	0	2	0	0	0	0	0	2	0	0	2	0	0	0	2
NRVSSGYRVAEAKDNAAYWSIA	3	2	0	1	50.00	50.00	3	0	0	0	0	0	0	0	2	3	0	0	3	0	0	0	0
EKLSSGYRINRAADDAAGLSIS	5	0	0	5	63.64	63.64	0	0	0	0	0	5	0	0	0	5	0	0	3	1	1	0	0
GQVSSGLRIESADDNAAYWSIA	1	0	0	1	54.55	50.00	1	0	0	0	0	0	0	0	0	1	0	0	1	0	0	0	0
RHISTGLAISSPKDNPAVWAIA	1	0	0	1	45.45	45.45	0	1	0	0	0	0	0	0	0	1	0	0	1	0	0	0	0
QRINTGKKVGNAKDNGAIWAIA	1	0	0	1	40.91	45.45	0	1	0	0	0	0	0	0	0	1	0	0	1	0	0	1	1
NRISTGQRVATASDNAAYWSIA	2	2	0	0	40.91	50.00	2	0	0	0	0	0	0	0	2	2	0	0	0	2	0	0	0
TRLSTGFRINSAMDDAAGLQIA	4	1	0	3	81.82	86.36	0	0	0	4	0	0	0	0	1	4	0	0	4	0	0	3	4
GRISSGLKVGDASDNAAYWSIA	1	1	0	0	54.55	40.91	1	0	0	0	0	0	0	0	1	1	0	0	1	0	0	0	0
EKLSSGYRINRAADDAAGLAIS	3	0	0	3	63.64	63.64	0	0	0	0	0	1	2	0	0	3	0	0	3	0	0	0	0
NRVSTGLRVSSAADNAAYWSIA	1	0	0	1	50.00	54.55	1	0	0	0	0	0	0	0	0	1	0	0	0	1	0	0	0
NRISTGLKIGQAKDNAAYWSIS	1	0	0	1	54.55	50.00	1	0	0	0	0	0	0	0	0	1	0	0	0	1	0	0	0
ERVTSGYKIASAADNSGYWSTA	1	1	0	0	40.91	31.82	1	0	0	0	0	0	0	0	1	1	0	0	0	1	0	0	0
QRLSSGLRINSAKDDAAGLAIT	1	0	0	1	81.82	81.82	0	0	0	1	0	0	0	0	0	1	0	0	1	0	0	0	1
QRLSSGLRVNSAKDDAAGLAIS	8	8	0	0	77.27	77.27	0	0	0	8	0	0	0	0	8	8	0	0	5	3	0	5	5
QQVSSGYRVETAADDATYWSFA	4	4	0	0	36.36	40.91	4	0	0	0	0	0	0	0	4	4	0	0	4	0	0	0	0
NRINTGLKISTAKDNGAIWAIA	1	0	0	1	50.00	45.45	0	1	0	0	0	0	0	0	0	1	0	0	1	0	0	0	0
GRVSSGLKVGAASDNAAYWSIA	2	2	0	0	54.55	40.91	2	0	0	0	0	0	0	0	2	2	0	0	2	0	0	0	0
DKLSSGQKINRGADDAAGLAIS	1	1	0	0	63.64	54.55	0	0	0	0	0	1	0	0	1	1	0	0	0	1	0	0	0
TRLSTGYRINSSMDDAAGLQIA	1	0	0	1	77.27	81.82	0	0	0	1	0	0	0	0	0	1	0	0	1	0	0	1	1
NRISTGLKIGEAKDNAAYWAIS	1	0	0	1	54.55	50.00	1	0	0	0	0	0	0	0	0	1	0	0	0	1	0	0	0
ERLSSGMRINSAKDDAAGQAIA	6	0	0	6	77.27	77.27	0	0	0	6	0	0	0	0	0	6	0	0	6	0	0	4	5
SRVSSGYRVAEAKDNAAYWSIA	3	1	0	2	50.00	50.00	3	0	0	0	0	0	0	0	1	3	0	0	3	0	0	0	0
QQVSTGMRIGKAEDNSAYWSIA	1	0	0	1	36.36	50.00	1	0	0	0	0	0	0	0	0	1	0	0	1	0	0	0	0
EKLSSGLRINSAADDAAGLSIS	1	0	0	1	72.73	68.18	0	0	0	0	0	1	0	0	0	1	0	0	1	0	0	0	0
EHLATGKKLNHASDNPANIAIV	3	3	0	0	36.36	36.36	0	0	0	0	0	3	0	0	3	3	0	0	3	0	0	0	0
QRLSSGLKINSAKDDAAGLQIS	2	0	0	2	90.91	81.82	0	0	0	0	2	0	0	0	0	2	0	0	0	2	0	0	0
TRLSTGYRINTASDDAAGLQIA	1	0	0	1	77.27	81.82	0	0	0	1	0	0	0	0	0	1	0	0	0	1	0	0	1
QRLSSGLRINTAKDDAAGLAIS	2	0	0	2	77.27	77.27	0	0	0	2	0	0	0	0	0	2	0	0	2	0	0	0	1
EKLSSGQRINRAADDAAGLAIS	1	0	0	1	63.64	63.64	0	0	0	0	0	0	1	0	0	1	0	0	0	1	0	0	0
QRINTGKKVGTAKDNGAIWAMA	1	0	0	1	36.36	40.91	0	1	0	0	0	0	0	0	0	1	0	0	1	0	0	0	0
EKLSSGQRINNAADDAAGLAIS	3	0	0	3	63.64	63.64	1	0	0	0	0	2	0	0	0	3	0	0	2	0	1	0	0
NEVSSGLRIQSAADNAAYWSIS	1	0	0	1	50.00	45.45	1	0	0	0	0	0	0	0	0	1	0	0	1	0	0	0	0
EKLSSGLRINKAADDAAGLSIS	1	1	0	0	68.18	63.64	0	0	0	0	0	1	0	0	1	1	0	0	1	0	0	0	0
SRINTGLDVNSTKDDSARYTIA	1	0	0	1	50.00	50.00	0	0	1	0	0	0	0	0	0	1	0	0	1	0	0	1	0
ARISTGYRVSSASDNAAYWSIA	2	2	0	0	45.45	54.55	2	0	0	0	0	0	0	0	2	2	0	0	2	0	0	0	0
RRVSSGYRVETASDNAGYWSIA	2	2	0	0	40.91	40.91	2	0	0	0	0	0	0	0	2	2	0	0	2	0	0	0	0
GQVSSGLRVATAGDNAAYWSIS	1	0	0	1	40.91	36.36	1	0	0	0	0	0	0	0	0	1	0	0	1	0	0	0	0
KHLATGKKLNNASDNPANIAIV	1	1	0	0	36.36	36.36	0	0	0	0	0	1	0	0	1	1	0	0	1	0	0	0	0
SRISSGLKVGSASDNAAYWSIA	2	2	0	0	59.09	45.45	2	0	0	0	0	0	0	0	2	2	0	0	2	0	0	0	0
TRLSTGLRINAASDDAAGLQIA	1	0	0	1	81.82	81.82	0	0	0	1	0	0	0	0	0	1	0	0	0	1	0	0	1
DRISSGLKVGSASDNAAYWSIA	4	4	0	0	59.09	45.45	4	0	0	0	0	0	0	0	4	4	0	0	4	0	0	0	4
